----------------------------------------------------------------------------------------------------------
----------------------------------------------------------------------------------------------------------
-----------------------%----------------------------------------------------------------------------------
-----------------------%----------------------------------------------------------------------------------
-----------------------%----------------------------------------------------------------------------------
-----------------------%----------------------------------------------------------------------------------
----------------------&%&---------------------------------------------------------------------------------
----------------------#%#---------------------------------------------------------------------------------
------------^^^^^^-----%----------------------------------------------------------------------------------
-----------------------#----------------------------------------------------------------------------------
---%-----%------------&-&---------------------------------------------------------------------------------
---%/////%--######----#-#---------------------------------------------------------------------------------
---%-----%-------------&----------------------------------------------------------------------------------
---%-----%-----------#-#-#--------------------------------------------------------------------------------
---%/////%--######----------------------------------------------------------------------------------------
---%-----%------------------------------------------------------------------------------------------------
-?-%-----%----------#--&--#----*-----------------------------------------------------------------------*--
##########################################################################################################
##########################################################################################################
##########################################################################################################
##########################################################################################################
##########################################################################################################
