----------------------------------------------------------------------------------------------------------
----------------------------------------------------------------------------------------------------------
----------------------------------------------------------------------------------------------------------
----------------------------------------------------------------------------------------------------------
----------------------------------------------------------------------------------------------------------
----------------------------------------------------------------------------------------------------------
----------------------------------------------------------------------------------------------------------
----------------------------------------------------------------------------------------------------------
##############################----------------------------------------------------------------------------
----------------------------------------------------------------------------------------------------------
----------------------------------------------------------------------------------------------------------
---#######----&&&&&&&-------------------------------------------------------------------------------------
--------------#######-------------------------------------------------------------------------------------
-------------########---^^^^^-----------------------------------------------------------------------------
--///-¤-///---#######-------------------------------------------------------------------------------------
--------------#######-------------------------------------------------------------------------------------
-?----------------------&&&&---#-*---------------------------------------------------------------------*--
##########################################################################################################
##########################################################################################################
##########################################################################################################
##########################################################################################################
##########################################################################################################
