----------------------------------------------------------------------------------------------------------
----------------------------------------------------------------------------------------------------------
----------------------------------------------------------------------------------------------------------
----------------------------------------------------------------------------------------------------------
----------------------------------------------------------------------------------------------------------
----------------------------------------------------------------------------------------------------------
----------------------------------------------------------------------------------------------------------
----------------------------------------------------------------------------------------------------------
----------------------------------------------------------------------------------------------------------
----------------------------------------------------------------------------------------------------------
----------------------------------------------------------------------------------------------------------
----------------------------------------------------------------------------------------------------------
---------------&&&&---------------------------------------------------------------------------------------
-------------######---------------------------------------------------------------------------------------
-----/////---######---------------------------------------------------------------------------------------
-------------######---------------------------------------------------------------------------------------
-?-----------######-&&&&&------------------------------------------------------------------------------*--
##########################################################################################################
##########################################################################################################
##########################################################################################################
##########################################################################################################
##########################################################################################################
