----------------------------------------------------------------------------------------------------------
----------------------------------------------------------------------------------------------------------
----------------------------------------------------------------------------------------------------------
----------------------------------------------------------------------------------------------------------
----------------------------------------------------------------------------------------------------------
----------------------------------------------------------------------------------------------------------
----------------------------------------------------------------------------------------------------------
-----&&&&&&&&&&&&&----------------------------------------------------------------------------------------
-----&&&&&&&&&&&&&----------------------------------------------------------------------------------------
-----&&&&&&&&&&&&&----------------------------------------------------------------------------------------
-----&&&&&&&&&&&&&----------------------------------------------------------------------------------------
-----&&&&&&&&&&&&&----------------------------------------------------------------------------------------
-----&&&&&&&&&&&&&----------------------------------------------------------------------------------------
-----&&&&&&&&&&&&&----------------------------------------------------------------------------------------
-----&&&&&&&&&&&&&----------------------------------------------------------------------------------------
-----&&&&&&&&&&&&&----------------------------------------------------------------------------------------
-?--#&&&&&&&&&&&&&#----*----------------------------------------------------------------------------------
##########################################################################################################
##########################################################################################################
##########################################################################################################
##########################################################################################################
##########################################################################################################
