----%-------------------%---------------------------------------------------------------------------------
----%&&&&&&&&&&&&&&&&&&&%---------------------------------------------------------------------------------
----%&&&&&&&&&&&&&&&&&&&%---------------------------------------------------------------------------------
----%&&&&&&&&&&&&&&&&&&&%---------------------------------------------------------------------------------
----%&&&&&&&&&&&&&&&&&&&%---------------------------------------------------------------------------------
----%&&&&&&&&&&&&&&&&&&&%---------------------------------------------------------------------------------
----%&&&&&&&&&&&&&&&&&&&%---------------------------------------------------------------------------------
----%&&&&&&&&&&&&&&&&&&&%---------------------------------------------------------------------------------
----%&&&&&&&&&&&&&&&&&&&%---------------------------------------------------------------------------------
----%&&&&&&&&&&&&&&&&&&&%---------------------------------------------------------------------------------
----%&&&&&&&&&&&&&&&&&&&%---------------------------------------------------------------------------------
----%&&&&&&&&&&&&&&&&&&&%---------------------------------------------------------------------------------
----%&&&&&&&&&&&&&&&&&&&%---------------------------------------------------------------------------------
///-%&&&&&&&&&&&&&&&&&&&%---------------------------------------------------------------------------------
----%&&&&&&&&&&&&&&&&&&&%---------------------------------------------------------------------------------
----#&&&&&&&&&&&&&&&&&&&#---------------------------------------------------------------------------------
-?--#&&&&&&&&&&&&&&&&&&&#--*---------------------------------------------------------------------------*--
##########################################################################################################
##########################################################################################################
##########################################################################################################
##########################################################################################################
##########################################################################################################
