----------------------------------------------------------------------------------------------------------
----------------------------------------------------------------------------------------------------------
----------------------------------------------------------------------------------------------------------
----------------------------------------------------------------------------------------------------------
----------------------------------------------------------------------------------------------------------
----------------------------------------------------------------------------------------------------------
----------------------------------------------------------------------------------------------------------
#####-------------------####¤####-------------------------------------------------------------------------
-----#-----------------#------%--#------------------------------------------------------------------------
------#---------------#-------%---#-----------------------------------------------------------------------
-------###############--------%----#############----------------------------------------------------------
-------------------------^#---%----#------------###-------------------------------------------------------
-------------------------###/#%--------------------#------------------------------------------------------
-------------------------^#---%----------##---------#-----------------------------------------------------
-----------^^¤^^^¤------------%---------------------#-----------------------------------------------------
------------------------------%---------------------#-----------------------------------------------------
-?----------------------------%----#----&--&----#-*-#--------------------------------------------------*--
############################¤#############################################################################
##########################################################################################################
##########################################################################################################
##########################################################################################################
##########################################################################################################
