----------------------------------------------------------------------------------------------------------
----------------------------------------------------------------------------------------------------------
----------------------------------------------------------------------------------------------------------
----------------------------------------------------------------------------------------------------------
----------------------------------------------------------------------------------------------------------
----------------------------------------------------------------------------------------------------------
----------------------------------------------------------------------------------------------------------
----------------------------------------------------------------------------------------------------------
----------------------------------------------------------------------------------------------------------
--%-------------------------------------------------------------------------------------------------------
--%-------------------------------------------------------------------------------------------------------
--%///////////--------------------------------------------------------------------------------------------
--%-------------------------------------------------------------------------------------------------------
--%-------------------------------------------------------------------------------------------------------
--%///////////--------------------------------------------------------------------------------------------
--%-------------------------------------------------------------------------------------------------------
-?%----------------------------------------------------------------------------------------------------*--
##########################################################################################################
##########################################################################################################
##########################################################################################################
##########################################################################################################
##########################################################################################################
