----------------------------------------------------------------------------------------------------------
----------------------------------------------------------------------------------------------------------
--------------------&---*---------------------------------------------------------------------------------
--------------------#---#---------------------------------------------------------------------------------
--------------------#-------------------------------------------------------------------------------------
-----------------&--#-------------------------------------------------------------------------------------
-----------------#--#-------------------------------------------------------------------------------------
-----------------#--#-------------------------------------------------------------------------------------
--------------&--#--#-------------------------------------------------------------------------------------
--------------#--#--#-------------------------------------------------------------------------------------
--------------#--#--#-------------------------------------------------------------------------------------
-----------&--#--#--#-------------------------------------------------------------------------------------
-----------#--#--#--#-------------------------------------------------------------------------------------
-----------#--#--#--#-------------------------------------------------------------------------------------
--------&--#--#--#--#-------------------------------------------------------------------------------------
--------#--#--#--#--#-------------------------------------------------------------------------------------
-?------#--#--#--#--#----------------------------------------------------------------------------------*--
##########################################################################################################
##########################################################################################################
##########################################################################################################
##########################################################################################################
##########################################################################################################
