----------------------------------------------------------------------------------------------------------
-------------------#--------------------------------------------------------------------------------------
-----#-------------#--------------------------------------------------------------------------------------
-----------------##---------------------------------------------------------------------------------------
--------------------##------------------------------------------------------------------------------------
-------------------#-#------------------------------------------------------------------------------------
----------------###-#-------------------------------------------------------------------------------------
-----------------#----------------------------------------------------------------------------------------
--------------##--#---------------------------------------------------------------------------------------
------------###-##----------------------------------------------------------------------------------------
--------------###-----#-----------------------------------------------------------------------------------
-----------#-#####---#------------------------------------------------------------------------------------
----------#-#-##--###-------------------------------------------------------------------------------------
-------------------#--------------------------------------------------------------------------------------
---------#------------------------------------------------------------------------------------------------
---------#------------------------------------------------------------------------------------------------
-?-----------------------------------------------------------------------------------------------------*--
##########################################################################################################
##########################################################################################################
##########################################################################################################
##########################################################################################################
##########################################################################################################
