----------------------------------------------------------------------------------------------------------
----------------------------------------------------------------------------------------------------------
----------------------------------------------------------------------------------------------------------
----------------------------------------------------------------------------------------------------------
----------------------------------------------------------------------------------------------------------
----------------------------------------------------------------------------------------------------------
----------------------------------------------------------------------------------------------------------
----------------------------------------------------------------------------------------------------------
----------------------------------------------------------------------------------------------------------
----------------------------------------------------------------------------------------------------------
----------------------------------------------------------------------------------------------------------
--------------------------####----------------------------------------------------------------------------
----------------------------------------------------------------------------------------------------------
----------------------------------------------------------------------------------------------------------
------------------######--###-----------------------------------------------------------------------------
----------------------------------------------------------------------------------------------------------
-?--------------------------------------------------------------------------------------------------------
#############---#####################-----------------####################################################
#############---#####################-----------------####################################################
#############---#####################-----------------####################################################
#############---#####################-----------------####################################################
#############---#####################-----------------####################################################