----------------------------------------------------------------------------------------------------------
----------------------------------------------------------------------------------------------------------
----------------------------------------------------------------------------------------------------------
----------------------------------------------------------------------------------------------------------
---------------------------------------%------------------------------------------------------------------
---------------------------------------%---%--------------------------------------------------------------
---------------------------------------%---%--------------------------------------------------------------
---------------------------------------%---%--------------------------------------------------------------
---------------------------------------%---%--------------------------------------------------------------
-------------------------------------------%--------------------------------------------------------------
-----------------------------------------%-%--------------------------------------------------------------
-----------------------------------------%----------------------------------------------------------------
------------------------------------#----%--%---##--------------------------------------------------------
-----------------------------------##----%--%####---------------------------------------------------------
----------------------------------###-------%-------------------------------------------------------------
---------------------------------####-------%-------------------------------------------------------------
-?---------------------&--------#####-------%----------------&-----------------------------------------*--
#############---######################------%--------#####################################################
#############---#####################---&---%----&----####################################################
#############---#####################-###############-####################################################
#############---#####################-----------------####################################################
#############---##########################################################################################