----------------------------------------------------------------------------------------------------------
----------------------------------------------------------------------------------------------------------
----------------------------------------------------------------------------------------------------------
----------------------------------------------------------------------------------------------------------
----------------------------------------------------------------------------------------------------------
----------------------------------------------------------------------------------------------------------
----------------------------------------------------------------------------------------------------------
----------------------------------------------------------------------------------------------------------
----------------------------------------------------------------------------------------------------------
----------------------------------------------------------------------------------------------------------
----------------------------------------------------------------------------------------------------------
----------------------------------------------------------------------------------------------------------
------------------------------------#---------------------------------------------------------------------
-----------------------------------##---------------------------------------------------------------------
----------------------------------###---------------------------------------------------------------------
---------------------------------####---------------------------------------------------------------------
-?------------------------------#####------------------------------------------------------------------*--
#############---######################---------------#####################################################
#############---#####################-----------------####################################################
#############---#####################-###############-####################################################
#############---#####################-----------------####################################################
#############---##########################################################################################