----------------------------------------------------------------------------------------------------------
------------------------------------------------------------####------------------------------------------
----------------------------------------------------------------------------------------------------------
------------------------------------------------------------##--------------------------------------------
-------------------------------------------------------------##---##---##--#######------------------------
--------------------------------------------------------------##--------------#---------------------------
---------------------------------------------------------------#############--#---------------------------
---------------------------------------------------------------------------#--#---------------------------
---------------------------------------------------------------------------##-#---------------------------
---------------------------------------------------------------------------#--#---------------------------
-----------------------------/---------------------------------------------#-##---------------------------
--------------------------####---------------------------------------------#--#---------------------------
------------------------------------------------------------------------------#---------------------------
---------------------/----------------------------------------------------###-#---------------------------
------------------######--###--------------------------------------------###--#---------------------------
-----------------------------------------#########----------------------####-##---------------------------
-?----------------/-----------------------------------------------------####--#------------------------*--
#############---#####################-----------------######################--#######--###################
#############---#####################-----------------#######################-######--####################
#############---#####################-----------------######################--#---#--#####################
#############---#####################-----------------######################----#---######################
#############---#####################-----------------####################################################