----------------------------------------------------------------------------------------------------------
----------------------------------------------------------------------------------------------------------
----------------------------------------------------------------------------------------------------------
---&------------------------------------------------------------------------------------------------------
----------------------------------------------------------------------------------------------------------
----------------------------------------------------------------------------------------------------------
--------------%-------------------------------------------------------------------------------------------
--------------%-------------------------------------------------------------------------------------------
--------------%-------------------------------------------------------------------------------------------
--------------%-------------------------------------------------------------------------------------------
--------------%-------------------------------------------------------------------------------------------
--------------%-------------------------------------------------------------------------------------------
--------------%-------------------------------------------------------------------------------------------
--------------%-------------------------------------------------------------------------------------------
--------------%-------------------------------------------------------------------------------------------
------------&&%&&-----------------------------------------------------------------------------------------
-?----------&&%&&--------------------------------------------------------------------------------------*--
##########################################################################################################
##########################################################################################################
##########################################################################################################
##########################################################################################################
##########################################################################################################
