----------------------------------------------------------------------------------------------------------
----------------------------------------------------------------------------------------------------------
----------------------------------------------------------------------------------------------------------
----------------------------------------------------------------------------------------------------------
---------------------------------------------------------------------------#######------------------------
------------------------------------------------------------------------------#---------------------------
---------------------------------------------------------------------------#-##---------------------------
---------------------------------------------------------------------------#--#---------------------------
---------------------------------------------------------------------------##-#---------------------------
---------------------------------------------------------------------------#--#---------------------------
---------------------------------------------------------------------------#-##---------------------------
--------------------------####---------------------------------------------#--#---------------------------
------------------------------------------------------------------------------#---------------------------
--------------------------------------------------------------------------###-#---------------------------
------------------######--###--------------------------------------------###--#---------------------------
-----------------------------------------#########----------------------####--#---------------------------
-?----------------------------------------------------------------------####--#------------------------*--
#############---#####################-----------------######################-########--###################
#############---#####################-----------------######################--######--####################
#############---#####################-----------------######################--#---#--#####################
#############---#####################-----------------######################----#---######################
#############---#####################-----------------####################################################