----------------------------------------------------------------------------------------------------------
----------------------------------------------------------------------------------------------------------
----------------------------------------------------------------------------------------------------------
----------------------------------------------------------------------------------------------------------
------------&&&&------------------------------------------------------------------------------------------
------------&&&&------------------------------------------------------------------------------------------
------------&&&&------------------------------------------------------------------------------------------
------------&&&&------------------------------------------------------------------------------------------
------------&&&&------------------------------------------------------------------------------------------
----------%-&&&&&-----------------------------------------------------------------------------------------
----------%#&&&&#-----------------------------------------------------------------------------------------
----------%######-----------------------------------------------------------------------------------------
----------%#%---#-----------------------------------------------------------------------------------------
----------%#%///#-----------------------------------------------------------------------------------------
----------%#%---#-----------------------------------------------------------------------------------------
-----------#%---#-----------------------------------------------------------------------------------------
-?----------%---#--------------------------------------------------------------------------------------*--
##########################################################################################################
##########################################################################################################
##########################################################################################################
##########################################################################################################
##########################################################################################################
