----------------------------------------------------------------------------------------------------------
----------------------------------------------------------------------------------------------------------
----------------------------------------------------------------------------------------------------------
----------------------------------------------------------------------------------------------------------
----------------------------------------------------------------------------------------------------------
##########-#-#-#-#-#-#-#-#-#-#-#######--------------------------------------------------------------------
----------------------------------------------------------------------------------------------------------
----------------------------------------------------------------------------------------------------------
----------------------------------------------------------------------------------------------------------
----------------------------------------------------------------------------------------------------------
----------------------------------------------------------------------------------------------------------
----------------------------------------------------------------------------------------------------------
----------------------------------------------------------------------------------------------------------
----------------------------------------------------------------------------------------------------------
----¤-----------------------------------------------------------------------------------------------------
----------------------------------------------------------------------------------------------------------
-?-------#-&-&-&-&-&-&-&-&-&-&-#-----------------------------------------------------------------------*--
##-#-#-#-#################################################################################################
##########################################################################################################
##########################################################################################################
##########################################################################################################
##########################################################################################################
