----------------------------------------------------------------------------------------------------------
----------------------------------------------------------------------------------------------------------
----------------------------------------------------------------------------------------------------------
----------------------------------------------------------------------------------------------------------
----------------------------------------------------------------------------------------------------------
----------------------------------------------------------------------------------------------------------
----------------------------------------------------------------------------------------------------------
-------------&&-------------------------------------------------------------------------------------------
----------------------------------------------------------------------------------------------------------
-----------^^^^^^-----------------------------------------------------------------------------------------
----------------------------------------------------------------------------------------------------------
----------%------#---&------------------------------------------------------------------------------------
----------%############/////------------------------------------------------------------------------------
----------%-----------#-----------------------------------------------------------------------------------
----------%##########-#-----------------------------------------------------------------------------------
----------%-----------#-----------------------------------------------------------------------------------
-?--------%##########-----*----------------------------------------------------------------------------*--
##########################################################################################################
##########################################################################################################
##########################################################################################################
##########################################################################################################
##########################################################################################################
